10 0 2 3 2 3 5 12 5 12 2
2 1 0 0 0
3 2 1 0 0
4 3 3 2 0
4 4 4 3 2
5 4 3 3 3
5 5 4 3 4
6 6 5 3 3
7 7 7 5 5


